EEEEEEEEEEEEEEEEEEEEEEEEEEEEEEEEEEEEEEEEEEEEEEEEEEEEEEEEEEEEEEEEEEEEEE
ES                                     EccccccccccHE                 E
EEEEEEEEEEEEEEEEEEE                    EEEEEEEEEEEHE                 E
EC        H ccccE                                 HE                 E
EH        H  cccE  EEEEEEE                        HE                 E
EHEEEEEEEEEEEEccE           EEEEEEEE              HE                 E
EHc            cE^^^^^^^                          HE                 E
EHcc          ccEEEEEEEEEEEEEEEEEEEEEEEEEEE       HE                 E
EHccc        ccc              c HE           EE   HE                 E
EHcccccccccccccc              c HE              EEHE                 E
EEEEEEEEEEEEEEEEEHEEEEEEEEEEEEEEHE^^^^^^^^^^^^^^^EHE                 E+
E                H             EHEEEEEEEEEEEEEEEEEHE                 E
E                H             EH       cccccccccEHE                 E
E                H             EH               cEHE                 E
E EEEEEEEEEEEEEEEEEEEEE        EHEE^EEE^EEEE^EEEEEHE                 E
E                              EH                PHE                 E
E                              EEEEEEEEEEEEEEEEEEEEE                 E
E                                                                    E
E                                                                    E
E^^^^^^^^^^^^^^^^^^^^^^^^^^^^^^^^^^^^^^^^^^^^^^^^^^^^^^^^^^^^^^^^^^^^E
EEEEEEEEEEEEEEEEEEEEEEEEEEEEEEEEEEEEEEEEEEEEEEEEEEEEEEEEEEEEEEEEEEEEEE
