%%%%%%%%%%%%%%%%%%%%%%%%%%%%%%%%%%%%%%%%%%%%%%%%%%%%%%%%%%%%%%%%%%%%%%%%%%%%%%%%%%%%%%%%%%%%%%%%%%%%
%                                                                                                  %
%                                                                                                  %
%                                                                                                  %
%                                                                                                  %
%                                                                                                  %
%                                                                                                  %
%                                                                                                  %
%                                                                                                  %
%                                                                                                  %
%                                                                                                  %
%                                                                                                  %
%                                                                                                  %
%                                                                                                  %
%                                                                                                  %
%                                                                                                  %
%                                                                                                  %
%                                                                                                  %
%                                                                                                  %
%                                                                                                  %
%                                                                                                  %
%                                                                                                  %
%                                                                                                  %
%                                                                                                  %
%                                                                                                  %
%                                                                                                  %
%                                                                                                  %
%                                                                                                  %
%                                                                                                  %
E                                                                                                  %
E                                                                                                  %
E                                                                                                  %
E                                                                                                  %
E                                                                                                  %
E                                                                                                  %
E                                                                                                  %
E                                                                                                  %
E                                                                                                  %
E                                                                                                  %
E                                                                                                  %
E                                                                                                  %
E                                                                                                  %
E                                                                                                  %
E               !                                                                                  %
EEEEEEEEEEEEEEEEHEEEEEEEEEEEEE                                                                     %
EEEEEEEEEEEEEEEEH            E                                                                     %
EEEEEEEEEEEEEEEEH            E                                                                     %
EEEEEEEEEEEEEEEEH            E                                                                     %
EEEEEEEEEEEEEEEEH            E                                                                     %
EEEEEEEEEEEEEEEEH            E                                                                     %
Ec c c c c EEEEEH            E                                                                     %
E c c c c cEEEEEH            E                                                                     %
Ec c c c c EEEEEH            E                                                                     %
E#oEEEEEEEEEEEEEH            E                                                                     %
E#o             H            E                                                                     %
E#o             H            E                                                                     %
E#o             H            E                                                                     %
E#o             H            E                                                                     %
E#o             H            E                                                                     %
E#o             H            E                                                                     %
E#o             H            E                                                                     %
E#ooooooofo#####H  q    #####E                                                                     %
E###WofW#####################E                                                                     %
EEEEEEEEEEEEEEEEEEEEEEEEEEEEEE                                                                     %
EC                           E                                                                     %
E                            E                                                                     %
E                            E                                                                     %
EE                           E                                                                     %
EE                           E                                                                     %
EE#       !!!!!!!!!!!!!!!!!EDE                                                                     %
E## nHE                    EDE                                                                     %
E##ccHE                    EDEE                                                                    %
E$$ccHEE                   (D)E                                                                    %
E$#ccHEE                   (D)E                                                                    %
E$$##EEEEEEEEEEEEEEEEEEEEEHEEEE                                                                    %
EE$#E   ############E     HE                                                                       %
EDDE       U      U E     HE                                                                       %
EDE                       HE                                !                                      %
ED                        HE                                !                                      %
EE                  E     H                                 !                                      %
E(  S [ T       F   E     H                                 !                                      %
EDEEEEEEEEEE###$$###EEEEEEH                                 !                                      %
EDEEEEEEEEEEEEEDDEEEEEEEEEH                                 !                                      %
EDEEEEEEEEEEEEEDDEEEEEEEEEH                                 !                                      %
EDEEEEEEEEEEEEEDDEEEEEEEEEE     F 4                         !                                      %
EDEEEEEEEEEEEEEDDEEEEEEEEEEE#########ss                    s                                       %
EDEEEEEEEEEEEEE^^EEEEEEEEEEE#########sssss             sssss                                       %
EDEEEEEEEEEEEEEEEEEEEEEEEEEE#########ssssssooooooooooossss##                                       %
E              EEEEEEEEEEEEE##########sssssssssoofoossss####                                       %
E            C  EEEEEEEEEEEE#############ssssssssss$sss#####                                       %
EEEEEEEEEEEEEE  EEEEEEEEEEEE#################ssss##$s#######                                       %
E##############    ################################$########                                       %
E##############    ################################$########                                       %
E###############   ################################$#########                                      %
E###############   ################################$#########                                      %
E################  #######$$$$$$$$$$$$$$$$$$$$$$$$$$#########                                      %
E################  #######$$$$$$$$$$$$$$$$$$$$$$$$$$     ####                                      %
E################# (cccc    #######################$ ]   ###                                       %
E################# (cccc    ###########################^^###                                       %
EEEEEEEEEEEEEEEEEEEEEEEEEEEEEEEEEEEEEEEEEEEEEEEEEEEEEEEEEEEEEEEEEEEEEEEEEEEEEEE%%%%%%%%%%%%%%%%%%%%%
